Rent - прокат,
Nut - орехи,
Plum - сливы,
Pocket - карман,
Wrist - зап€стье,
according to - в соответствии с(согласно),
adjective - прилагательное,
as for - что касаетс€,
besides - кроме(за исключением),
beyond - за,
against - против,
below - ниже(под),
Boil - кипеть,
by means of - с помощью(посредством),
Blend - смесь,
Adjacent - прилегающий(р€дом),
beside - р€дом,
crawl - ползать,
Coal - уголь,
Cope - справл€тьс€,
Confident - уверенный в себе,
Dirt - гр€зный,
doubt - сомнение,
depend - зависеть,
Delivery - доставка,
Fame - слава,
fortunately - к счастью,
fines - штрафы,
Kettle - чайник,
in addition to - в дополнение к,
in case of - в случае,
in front of - перед,
in place of - вместо,
in spite of - несмотр€ на,
instead of - вместо,
Jester - шут,
Hail - приветствовать,
Milestone - этап,
Prospect - перспектива,
opposite - напротив,
regarding - относительно,
Relevant - уместный,
reckon - рассчитывать,
Swig - глоток,
Sign - знак,
reference - справка,
sin - грех,
unlike - в отличие от,
up to - вплоть до,
wag - вил€ть,
conmen - аферист,
correspondence - переписка,
scam - афера,
senior - старший,
identify - личность,
rather - скорее,
thin - худой,
tall - высокий(человек),
suit - костюм,
pot - горшок,
menace - угроза,
pipe - труба,
pretend - притвор€тьс€,
victim - жертва,
wand - посох,
cradle - люлька(истоки),
whale - кит,
quite - довольно,
expectation - ожидание(надежды),
extinct - вымерших,
eventually - в конце концов,
fried - жареный,
politely - вежливый,
ceiling - потолок,
instance - пример,
relation - св€зь,
hostess - хоз€йка



